PPPPPPPPPPPPPPP
P.........PPPPP
P.........PPP.P
P.........PWPPP
P.........PPPPP
P.........PPPPP
P.......W.....P
P......PPP....P
P.............P
P.....P.......P
P.............P
P.............P
P.............P
P.............P
P......H......PB
PPPPPPPPPPPPPPP
