PPPPPPPPPPPPPPP
P..B.B.B.B.B..P
P.B.B.B.B.B.B.P
P.PPPPPPPPPPP.P
P.............P
PW...F...F..W.P
PPPP.......PPPP
P.............P
P.............P
P.F.........F.P
P......P......P
P.............P
P.............P
P.............P
P......H......P
PPPPPPPPPPPPPPP