PPPPPPPPPPPPPPP
PF............P
P.............P
P...W.......W.P
P..B..B.B..B.FP
P.............P
P......B......P
P.............P
P...W.B.B...W.P
P..B.......B..P
P.............P
P.............P
PP.P.P.P.P.P.PP
P.............P
P......H......P
PPPPPPPPPPPPPPP