PPPPPPPPPPPPPPP
PF.F.F.F.F.F.FP
PPPPPPPPPPPPPPP
P..BW.....WB..P
PPPPP.....PPPPP
P.............P
P...BB...BB...P
P..B..B.B..B..P
P..B...B...B..P
P..B.......B..P
P...B.....B...P
P....B...B....P
P.....B.B.....P
PPP....B....PPP
PBF....H....FBP
PPPPPPPPPPPPPPP