PPPPPPPPPPPPPPP
P.............P
P.B.B.........P
P..F......BW..P
P.B.B...PPPPP.P
P.............P
P.............P
P......BW.....P
P....PPPPP....P
P.............P
P.............P
P...BW....B.B.P
P.PPPPP.......P
P.........B.B.P
P......H.W....P
PPPPPPPPPPPPPPP