PPPPPPPPPPPPPPP
P....B........P
P...PPPPP.....P
P.B.W.........P
PPPPP.........P
P...........PPP
P........W..B.P
P........PPPPPP
P.............P
P...F.........P
P..........B..P
PPPPP.........P
P....B........P
P.............P
P......H......P
PPPPPPPPPPPPPPP