PPPPPPPPPPPPPPP
P.............P
P.F....B....F.P
P.............P
PBW....B....WBP
PPP.........PPP
PWB....B....BWP
PPP.........PPP
P......H......P
P....PPPPP....P
P.B..PBBBP..B.P
P..B.P.F.P.B..P
P.B..P...P..B.P
P.............P
P..W..........P
PPPPPPPPPPPPPPP