PPPPPPPPPPPPPPP
PP.......W...PP
P..PP.PPPPPP..P
P.PP.....PBPP.P
P..PPP.P.P.P..P
PP.P.PPP.P.P.PP
P..P...P.W.P..P
P.PPP.PPPPPPP.P
P...W...P.....P
PPPPPPP.P.PP.PP
P.....P.P..P..P
P.PPP.P.PP.PP.P
P...P..W....P.P
PPP.PPPPPPP.P.P
P......H......P
PPPPPPPPPPPPPPP